31
15
...............................
.............WWWWW.............
.............WWSWW.............
.............WW.WW.............
.............WW.WW.............
.............WWBWW.............
.....WWWWWWWWWW.WWWWWWWWWW.....
.....WS......B.P.B......SW.....
.....WWWWWWWWWW.WWWWWWWWWW.....
.............WWBWW.............
.............WW.WW.............
.............WW.WW.............
.............WWSWW.............
.............WWWWW.............
...............................
