31
15
WWWWWWWWWWWWWWWWWWWWWWWWWWWWWWW
WWWWWWWWWWWWWWWWWWWWWWWWWWWWWWW
WWWWWWWWWWWWWWWSWWWWWWWWWWWWWWW
WWWWWWWWWWWWWWW.WWWWWWWWWWWWWWW
WWWWWWWWWWWWWWW.WWWWWWWWWWWWWWW
WWWWWWWWWWWWWWWBWWWWWWWWWWWWWWW
WWWWWWWWWWWWWWW.WWWWWWWWWWWWWWW
WWWWWWS......B.P.B......SWWWWWW
WWWWWWWWWWWWWWW.WWWWWWWWWWWWWWW
WWWWWWWWWWWWWWWBWWWWWWWWWWWWWWW
WWWWWWWWWWWWWWW.WWWWWWWWWWWWWWW
WWWWWWWWWWWWWWW.WWWWWWWWWWWWWWW
WWWWWWWWWWWWWWWSWWWWWWWWWWWWWWW
WWWWWWWWWWWWWWWWWWWWWWWWWWWWWWW
WWWWWWWWWWWWWWWWWWWWWWWWWWWWWWW
