31
15
WWWWWWWWWWWWWWWWWWWWWWWWWWWWWWW
WWWWWWWWWWWWWWW.WWWWWWWWWWWWWWW
WWWWWWWWWWWWWWWSWWWWWWWWWWWWWWW
WWWWWWWWWWWWWWW.WWWWWWWWWWWWWWW
WWWWWWWWWWWWWWW.WWWWWWWWWWWWWWW
WWWWWWWWWWWWWWWBWWWWWWWWWWWWWWW
WWWWWWWWWWWWWWW.WWWWWWWWWWWWWWW
WWWWW.S......B.P.B......S.WWWWW
WWWWWWWWWWWWWWW.WWWWWWWWWWWWWWW
WWWWWWWWWWWWWWWBWWWWWWWWWWWWWWW
WWWWWWWWWWWWWWW.WWWWWWWWWWWWWWW
WWWWWWWWWWWWWWW.WWWWWWWWWWWWWWW
WWWWWWWWWWWWWWWSWWWWWWWWWWWWWWW
WWWWWWWWWWWWWWW.WWWWWWWWWWWWWWW
WWWWWWWWWWWWWWWWWWWWWWWWWWWWWWW
