31
15
.............WWWWW.............
.............WW.WW.............
.............WWSWW.............
.............WW.WW.............
.............WW.WW.............
.............WWBWW.............
...WWWWWWWWWWWW.WWWWWWWWWWWW...
...WW.S......B.P.B......S.WW...
...WWWWWWWWWWWW.WWWWWWWWWWWW...
.............WWBWW.............
.............WW.WW.............
.............WW.WW.............
.............WWSWW.............
.............WW.WW.............
.............WWWWW.............
