31
15
...............................
...............W...............
..............WWW..............
.............WWSWW.............
............WWWSWWW............
...........WW..B..WW...........
..........WWW..B..WWW..........
.........WWWW..P..WWWW.........
..........WWW..B..WWW..........
...........WW..B..WW...........
............WWWSWWW............
.............WWSWW.............
..............WWW..............
...............W...............
...............................
