31
15
WWWWWWWWWWWWWWWWWWWWWWWWWWWWWWW
WWWWWWWWWWWWWWWWWWWWWWWWWWWWWWW
WWWWWWWWWWWWWWWWWWWWWWWWWWWWWWW
WWWWWWWWWWWWWWWSWWWWWWWWWWWWWWW
WWWWWWWWWWWWWWWSWWWWWWWWWWWWWWW
WWWWWWWWWWWWW..B..WWWWWWWWWWWWW
WWWWWWWWWWWWW..B..WWWWWWWWWWWWW
WWWWWWWWWWWWW..P..WWWWWWWWWWWWW
WWWWWWWWWWWWW..B..WWWWWWWWWWWWW
WWWWWWWWWWWWW..B..WWWWWWWWWWWWW
WWWWWWWWWWWWWWWSWWWWWWWWWWWWWWW
WWWWWWWWWWWWWWWSWWWWWWWWWWWWWWW
WWWWWWWWWWWWWWWWWWWWWWWWWWWWWWW
WWWWWWWWWWWWWWWWWWWWWWWWWWWWWWW
WWWWWWWWWWWWWWWWWWWWWWWWWWWWWWW
