31
15
WWWWWWWWWWWWWWWWWWWWWWWWWWWWWWW
WWWWWWWWWWWWWWW.WWWWWWWWWWWWWWW
WWWWWWWWWWWWS.....SWWWWWWWWWWWW
WWWWWWWWWWWWWW...WWWWWWWWWWWWWW
WWWWWWSWWWWWWWW.WWWWWWWWSWWWWWW
WWWWWW.WWWWWW..B..WWWWWW.WWWWWW
WWWWWW..WWWWW..B..WWWWW..WWWWWW
WWWWW........BBPBB........WWWWW
WWWWWW..WWWWW..B..WWWWW..WWWWWW
WWWWWW.WWWWWW.....WWWWWW.WWWWWW
WWWWWWSWWWWWWWWBWWWWWWWWSWWWWWW
WWWWWWWWWWWWWW...WWWWWWWWWWWWWW
WWWWWWWWWWWWS.....SWWWWWWWWWWWW
WWWWWWWWWWWWWWW.WWWWWWWWWWWWWWW
WWWWWWWWWWWWWWWWWWWWWWWWWWWWWWW
