31
15
..............WWW..............
...........WWWW.WWWW...........
...........WS.....SW...........
.....WWW...WWW...WWW...WWW.....
.....WSW....WWW.WWW....WSW.....
.....W.WW...W..B..W...WW.W.....
....WW..WWWWW..B..WWWWW..WW....
....W........BBPBB........W....
....WW..WWWWW..B..WWWWW..WW....
.....W.WW...W.....W...WW.W.....
.....WSW....WWWBWWW....WSW.....
.....WWW...WWW...WWW...WWW.....
...........WS.....SW...........
...........WWWW.WWWW...........
..............WWW..............
