31
15
...............................
...............................
..............WW...............
............WWWWWW.............
..........WWWWWWWWWW...........
........WWWWWWWWWWWWWW.........
........W........B..SW.........
........WP......B.B.SW.........
........WWWWWWWWWWWW.W.........
........W..........W.W.........
........W..........W.W.........
........W..........WSW.........
........W..........WWW.........
...............................
...............................
