31
15
WWWWWWWWWWWWWWWWWWWWWWWWWWWWWWW
WWWWWWWWWWWWWWWWWWWWWWWWWWWWWWW
WWWWWWWWWWWWWWWWWWWWWWWWWWWWWWW
WWWWWWWWWWWWWWWWWWWWWWWWWWWWWWW
WWWWWWWWWWWWWWWWWWWWWWWWWWWWWWW
WWWWWWWWWWWWWWWWWWWWWWWWWWWWWWW
WWWWWWWWW........B..SWWWWWWWWWW
WWWWWWWWWP......B.B.SWWWWWWWWWW
WWWWWWWWWWWWWWWWWWWW.WWWWWWWWWW
WWWWWWWWWWWWWWWWWWWW.WWWWWWWWWW
WWWWWWWWWWWWWWWWWWWW.WWWWWWWWWW
WWWWWWWWWWWWWWWWWWWWSWWWWWWWWWW
WWWWWWWWWWWWWWWWWWWWWWWWWWWWWWW
WWWWWWWWWWWWWWWWWWWWWWWWWWWWWWW
WWWWWWWWWWWWWWWWWWWWWWWWWWWWWWW
