31
15
...............................
...............................
........WWWWW..................
........W...W..................
........WB..W..................
......WWW..BWW.................
......W..B.B.W.................
....WWW.W.WW.W...WWWWWW........
....W...W.WW.WWWWW..SSW........
....W.B..B..........SSW........
....WWWWW.WWW.WPWW..SSW........
........W.....WWWWWWWWW........
........WWWWWWW................
...............................
...............................

