31
11
.........................
....................WWW..
..................WWWSW..
.........WWWWW....WSBBW..
.......WWW...W....WWW.W..
.......W.B.W.WW....WW.W..
.......W.W..S.W...WW..W..
.......W....W.W...WSB.W..
.......WW.W...W...WWP.W..
........WP..WWW....WWWW..
........WWWWW............

