25
15
.........................
.....WWWWW...............
.....W...WW..............
....WWSWB.WW.............
....W.B....W.............
....WS.SWB.W.............
....WWW.P.WW.....WWWWW...
......W.W.W......W...WW..
......W...W.....WWSWB.W..
......WWWWW.....W.B....W.
................WS.SWB.W.
................WWW.P.WW.
..................W.W.W..
..................W...W..
..................WWWWW..
