31
17
WWWWWWWWWWWWWWWWWWWWWWWWWWWWWWW
WWWWWWWWWWWWW..WWWWWWWWWWWWWWWW
WWWWWWWWWWWW...WWWWWWWWWWWWWWWW
WWWWWWWWWWW...BSWWWWWWWWWWWWWWW
WWWWWWWWWW..B.BSWWWWWWWWWWWWWWW
WWWWWWWWW.WWWWWS.WWWWWWWWWWWWWW
WWWWWWWWW.....BSP.WWWWWWWWWWWWW
WWWWWWWWW.....BS.WWWWWWWWWWWWWW
WWWWWWWWWWW.W.WBW.W.WWWWWWWWWWW
WWWWWWWWWWWWWW.SB.....WWWWWWWWW
WWWWWWWWWWWWW..SB.....WWWWWWWWW
WWWWWWWWWWWWWW.SWWWWW.WWWWWWWWW
WWWWWWWWWWWWWWWSB.B..WWWWWWWWWW
WWWWWWWWWWWWWWWSB...WWWWWWWWWWW
WWWWWWWWWWWWWWWW...WWWWWWWWWWWW
WWWWWWWWWWWWWWWW..WWWWWWWWWWWWW
WWWWWWWWWWWWWWWWWWWWWWWWWWWWWWW
